التأكيد	ʔattaʔkiːd
إليك	ʔiˈlaːk
بعض	baʕdˤ
الجمل	alʒumɑl
باللغة	billuɣa
العربية:	alʕarabijːa
مرحبا	marħaba
كيف	kajf
حالك؟تعلم	ħaalak? taʕallam
اللغات	alluɣaːt
الجديدة	alʒadiːda
الطقسميل	atˤtˤaqsmiːl
اليوم	aljawm
هل	hal
تستطيع	tastaˈtˤiːʕ
مساعدتي؟	musaːʕadatiː
أنا	ʔana
أعيش	ʔaʕiːʃ
في	fiː
مدينة	madiːna
جميلةإذا	ʒamiːla/ʔiðaː
كنت	kunt
بحاجة	biħaːʒa
إلى	ʔilaː
المزيد	almaziːd
من	min
الجمل	alʒumal
أو	ʔaw
لديك	ladajk
سؤال	suʔaːl
معين،	muʕajjan
فأنا	faʔana
هنا	huna
للمساعد	lilmusaːʕada

